10.ox
.....o.o..
..o..oo...
oo......o.
.o.......o
.oo...oo.o
.ooo..o.o.
.......o..
o.o.....o.
..o.o.....
.......o..